Seconds,Car,Truck,Bus,Motorcycle,Total Vehicles
1,12,1,0,0,13
2,12,1,0,0,13
3,10,2,0,0,12
4,9,3,1,0,13
5,10,2,1,0,13
6,11,1,0,0,12
7,7,4,0,0,11
8,10,1,0,0,11
9,7,1,0,0,8
10,8,0,0,0,8
11,9,0,0,0,9
12,9,0,0,0,9
13,7,1,0,0,8
14,7,1,1,0,9
15,10,1,2,0,13
16,12,2,0,0,14
17,11,1,0,0,12
18,12,1,0,0,13
19,11,0,0,0,11
20,12,1,0,0,13
21,12,3,0,0,15
22,12,2,0,0,14
23,11,2,0,0,13
24,10,3,0,0,13
25,13,1,0,0,14
26,12,1,0,0,13
27,10,2,0,0,12
28,13,2,0,0,15
29,11,3,0,0,14
30,15,2,1,0,18
31,14,0,1,0,15
32,12,1,1,0,14
33,12,2,0,0,14
34,12,1,0,0,13
35,15,1,0,0,16
36,14,1,0,0,15
37,12,1,0,0,13
38,14,1,0,0,15
39,14,0,0,0,14
40,14,1,0,0,15
41,16,0,0,0,16
42,16,0,0,0,16
43,15,0,0,0,15
44,15,2,0,0,17
45,16,0,0,0,16
46,15,0,0,0,15
47,14,1,0,0,15
48,12,0,0,0,12
49,12,0,0,0,12
50,15,0,0,0,15
51,14,0,0,0,14
52,15,0,0,0,15
53,16,0,0,0,16
54,11,2,0,0,13
55,13,1,0,0,14
56,11,0,0,0,11
57,8,0,0,0,8
58,10,0,0,0,10
59,10,1,0,0,11
60,11,1,0,0,12
61,8,1,0,0,9
62,9,1,0,0,10
63,8,2,0,0,10
64,12,1,0,0,13
65,13,1,0,0,14
66,16,1,0,0,17
67,13,1,0,0,14
68,15,1,0,0,16
69,16,0,0,0,16
70,12,0,2,0,14
71,12,1,2,0,15
72,10,2,1,0,13
73,12,1,0,0,13
74,13,1,0,0,14
75,12,3,0,0,15
76,14,1,0,0,15
77,15,0,0,0,15
78,15,1,0,0,16
79,14,0,0,0,14
80,14,1,0,0,15
81,14,0,0,0,14
82,13,1,0,0,14
83,12,0,0,0,12
84,14,0,0,0,14
85,16,0,0,0,16
86,17,0,0,0,17
87,16,0,0,0,16
88,16,0,0,0,16
89,15,1,0,0,16
90,13,1,0,0,14
91,16,0,0,0,16
92,13,2,0,0,15
93,12,0,0,0,12
94,12,0,0,0,12
95,12,1,0,0,13
96,12,1,0,0,13
97,9,1,0,0,10
98,13,1,0,0,14
99,15,1,0,0,16
100,14,1,0,0,15
101,13,1,0,0,14
102,15,1,0,0,16
103,15,2,0,0,17
104,11,1,0,0,12
105,13,1,1,0,15
106,14,2,1,0,17
107,11,0,1,0,12
108,12,1,0,0,13
109,13,2,0,0,15
110,14,1,0,0,15
111,15,1,0,0,16
112,15,1,1,0,17
113,13,2,0,0,15
114,12,1,1,0,14
115,12,1,0,0,13
116,12,2,0,0,14
117,14,1,0,0,15
118,15,0,0,0,15
119,14,0,0,0,14
120,16,0,0,0,16
121,19,0,0,0,19
122,19,0,0,0,19
123,16,2,0,0,18
124,12,1,0,0,13
125,11,1,1,0,13
126,14,2,1,0,17
127,14,1,0,0,15
128,14,3,0,0,17
129,17,3,0,0,20
130,15,2,0,0,17
131,16,3,0,0,19
132,13,3,0,0,16
133,16,2,0,0,18
134,18,2,0,0,20
135,15,2,1,0,18
136,17,2,1,0,20
137,17,1,0,0,18
138,18,1,0,0,19
139,18,1,0,0,19
140,19,0,0,0,19
141,20,0,0,0,20
142,20,0,0,0,20
143,16,0,0,0,16
144,15,0,0,0,15
145,16,0,1,0,17
146,16,0,1,0,17
147,22,0,1,0,23
148,21,0,0,0,21
149,19,0,0,0,19
150,19,1,0,0,20
151,15,0,0,0,15
152,16,0,0,0,16
153,16,0,0,0,16
154,13,1,0,0,14
155,15,1,0,0,16
156,14,1,0,0,15
157,14,2,0,0,16
158,11,2,1,0,14
159,11,2,0,0,13
160,9,3,0,0,12
161,13,1,0,0,14
162,11,1,0,0,12
163,11,0,0,0,11
164,9,0,0,0,9
165,10,0,0,1,11
166,11,0,0,0,11
167,13,1,0,0,14
168,13,0,0,0,13
169,11,0,0,0,11
170,12,0,0,0,12
171,12,0,0,0,12
172,12,0,0,0,12
173,12,0,0,0,12
174,11,2,0,0,13
175,8,1,0,0,9
176,9,1,0,0,10
177,10,1,0,0,11
178,15,1,0,0,16
179,10,1,0,0,11
180,16,0,0,0,16
181,13,1,0,0,14
182,17,0,0,0,17
183,16,0,0,0,16
184,12,1,0,0,13
185,14,0,0,0,14
186,15,0,0,0,15
187,14,0,0,0,14
188,16,0,0,0,16
189,13,0,0,0,13
190,17,0,0,0,17
191,10,0,0,0,10
192,12,2,0,0,14
193,14,0,0,0,14
194,11,1,1,0,13
195,11,0,1,0,12
196,8,1,0,0,9
197,8,3,0,0,11
198,12,2,0,0,14
199,11,3,0,0,14
200,14,1,0,0,15
201,11,2,0,0,13
202,12,0,0,0,12
203,14,1,0,0,15
204,11,1,0,0,12
205,13,0,0,0,13
206,13,0,0,0,13
207,13,0,0,0,13
208,14,1,0,0,15
209,14,0,0,0,14
210,13,1,0,0,14
211,12,1,0,0,13
212,13,0,0,0,13
213,10,0,0,0,10
214,11,0,0,0,11
215,10,0,0,0,10
216,10,0,0,0,10
217,9,2,0,0,11
218,9,0,0,0,9
219,11,0,0,0,11
220,9,0,0,0,9
221,11,0,0,0,11
222,9,0,0,0,9
223,9,1,0,0,10
224,9,2,0,0,11
225,10,0,0,0,10
226,8,0,0,0,8
227,9,2,0,0,11
228,13,1,0,0,14
229,11,1,0,0,12
230,11,2,0,0,13
231,12,2,0,0,14
232,10,1,0,0,11
233,13,0,0,0,13
234,13,1,0,0,14
235,10,2,0,1,13
236,9,1,0,0,10
237,7,0,0,0,7
238,8,0,0,0,8
239,10,0,0,0,10
240,11,1,0,0,12
241,11,0,0,0,11
242,10,1,0,0,11
243,14,1,0,0,15
244,9,0,1,0,10
245,9,1,1,0,11
246,7,1,0,0,8
247,6,1,0,0,7
248,8,1,0,0,9
249,8,0,0,0,8
250,7,2,0,0,9
251,7,0,0,0,7
252,8,0,0,0,8
253,8,2,0,0,10
254,8,2,1,0,11
255,8,2,1,0,11
256,8,2,1,0,11
257,9,1,0,1,11
258,11,2,0,1,14
259,10,0,0,0,10
260,11,0,0,0,11
261,13,1,0,0,14
262,11,1,0,0,12
263,9,1,0,0,10
264,11,0,0,0,11
265,12,0,0,0,12
266,13,0,0,0,13
267,10,0,0,0,10
268,6,1,0,0,7
269,6,1,0,0,7
270,11,0,1,0,12
271,12,3,0,0,15
272,10,1,0,0,11
273,11,1,0,0,12
274,12,1,0,0,13
275,13,0,0,0,13
276,13,0,0,0,13
277,15,0,1,0,16
278,12,1,1,0,14
279,15,1,1,0,17
280,15,1,0,0,16
281,15,1,0,0,16
282,15,0,0,0,15
283,14,1,0,0,15
284,11,1,0,0,12
285,9,1,0,0,10
286,11,1,0,0,12
287,11,1,0,0,12
288,11,0,0,0,11
289,11,0,0,0,11
290,11,1,0,0,12
291,12,0,0,0,12
292,11,0,0,0,11
293,10,0,0,0,10
294,10,0,0,0,10
295,10,0,0,0,10
296,10,0,0,0,10
297,13,1,0,0,14
298,12,1,0,0,13
299,13,1,0,0,14
300,14,1,0,0,15
301,15,2,0,0,17
302,12,2,0,0,14
303,9,0,0,0,9
304,8,1,0,0,9
305,9,1,0,0,10
306,9,1,0,0,10
307,7,1,0,0,8
308,7,1,0,0,8
309,7,0,0,0,7
310,11,1,0,0,12
311,9,1,0,0,10
312,9,2,0,0,11
313,10,0,0,0,10
314,14,0,0,0,14
315,9,0,0,0,9
316,8,1,0,0,9
317,13,0,0,0,13
318,12,1,0,0,13
319,12,0,0,0,12
320,11,0,0,0,11
321,11,0,0,0,11
322,10,1,1,0,12
323,8,2,0,0,10
324,10,2,0,0,12
325,11,2,0,0,13
326,9,3,0,0,12
327,13,2,0,0,15
328,11,1,0,0,12
329,12,0,1,0,13
330,8,0,1,0,9
331,8,1,1,0,10
332,8,1,1,0,10
333,10,3,0,0,13
334,8,2,0,0,10
335,8,2,0,0,10
336,12,1,0,0,13
337,13,0,0,0,13
338,12,1,0,0,13
339,14,1,0,0,15
340,12,0,0,0,12
341,12,0,0,0,12
342,13,0,0,0,13
343,16,0,0,0,16
344,11,0,0,0,11
345,14,0,0,0,14
346,17,0,0,0,17
347,15,0,0,0,15
348,15,0,0,0,15
349,14,0,0,1,15
350,12,0,0,0,12
351,16,0,0,0,16
352,15,0,0,0,15
353,15,0,0,0,15
354,15,0,0,0,15
355,14,0,0,0,14
356,12,0,0,0,12
357,11,2,0,0,13
358,9,2,0,0,11
359,13,2,0,0,15
360,12,2,0,0,14
361,11,2,0,0,13
362,11,0,0,0,11
363,14,0,0,0,14
364,12,1,0,0,13
365,10,1,0,0,11
366,11,1,0,0,12
367,12,1,0,0,13
368,15,2,0,0,17
369,14,2,0,0,16
370,14,1,0,0,15
371,15,2,0,0,17
372,14,2,0,0,16
373,15,1,0,0,16
374,17,1,0,0,18
375,15,0,0,0,15
376,14,1,0,0,15
377,12,0,0,0,12
378,16,0,0,0,16
379,14,0,0,0,14
380,11,1,0,0,12
381,11,2,0,0,13
382,11,0,0,0,11
383,12,2,0,0,14
384,12,1,0,0,13
385,8,2,0,0,10
386,8,1,1,0,10
387,7,1,1,0,9
388,10,1,0,0,11
389,11,1,0,0,12
390,11,1,0,0,12
391,13,0,0,0,13
392,11,2,0,0,13
393,8,0,0,0,8
394,9,1,0,0,10
395,9,1,0,0,10
396,9,1,0,0,10
397,12,2,0,0,14
398,11,1,0,0,12
399,11,1,0,0,12
400,10,1,0,0,11
401,12,0,0,0,12
402,12,0,0,0,12
403,9,0,0,0,9
404,11,0,0,0,11
405,13,0,0,0,13
406,11,0,1,0,12
407,14,1,0,0,15
408,12,1,0,0,13
409,13,1,0,0,14
410,13,1,0,0,14
411,11,2,0,0,13
412,12,2,0,0,14
413,9,0,2,0,11
414,11,1,1,0,13
415,12,2,0,0,14
416,11,1,0,0,12
417,15,2,0,0,17
418,12,0,0,0,12
419,11,1,0,0,12
420,10,1,0,0,11
421,12,1,0,0,13
422,11,1,0,0,12
423,13,1,0,0,14
424,10,2,0,0,12
425,13,1,0,0,14
426,10,1,1,0,12
427,9,1,1,0,11
428,9,3,0,0,12
429,11,2,1,0,14
430,10,3,0,0,13
431,10,2,0,0,12
432,7,0,0,0,7
433,6,0,1,0,7
434,5,1,1,0,7
435,8,2,0,0,10
436,8,2,0,0,10
437,9,3,0,0,12
438,6,4,0,0,10
439,9,1,0,0,10
440,10,2,0,0,12
441,12,0,0,0,12
442,12,0,0,0,12
443,12,0,0,0,12
444,11,1,0,0,12
445,13,1,0,0,14
446,14,1,0,0,15
447,13,2,0,0,15
448,13,1,0,0,14
449,11,0,0,0,11
450,13,0,0,0,13
451,10,0,0,0,10
452,12,1,0,0,13
453,15,0,0,0,15
454,14,2,0,0,16
455,13,1,0,0,14
456,17,1,0,0,18
457,16,0,0,0,16
458,17,1,0,0,18
459,14,1,0,0,15
460,12,2,0,0,14
461,13,4,0,0,17
462,11,1,0,0,12
463,13,1,0,0,14
464,13,1,0,0,14
465,12,0,0,0,12
466,14,0,0,0,14
467,12,0,0,0,12
468,14,0,0,0,14
469,14,0,0,0,14
470,15,0,0,0,15
471,11,0,1,0,12
472,11,0,1,0,12
473,9,1,1,0,11
474,9,1,0,0,10
475,9,3,0,0,12
476,9,2,0,0,11
477,10,3,0,0,13
478,11,3,0,0,14
479,11,1,0,0,12
480,14,1,0,0,15
481,12,0,0,0,12
482,12,0,0,0,12
483,11,0,0,0,11
484,11,0,0,0,11
485,9,1,0,0,10
486,8,0,0,0,8
487,7,1,0,0,8
488,8,1,0,0,9
489,8,1,0,0,9
490,9,1,0,0,10
491,7,1,0,0,8
492,7,2,0,0,9
493,9,1,0,0,10
494,13,2,0,0,15
495,10,1,0,0,11
496,12,1,0,0,13
497,10,2,0,0,12
498,7,2,0,0,9
499,12,3,0,0,15
500,12,3,1,0,16
501,14,2,0,0,16
502,15,1,0,0,16
503,18,1,0,0,19
504,16,1,0,0,17
505,14,1,0,0,15
506,17,0,0,0,17
507,17,1,0,0,18
508,15,1,0,0,16
509,14,1,1,0,16
510,13,0,0,0,13
511,12,2,0,0,14
512,12,1,0,0,13
513,9,1,0,0,10
514,11,0,0,0,11
515,11,0,0,0,11
516,14,0,0,0,14
517,10,0,0,0,10
518,11,0,0,0,11
519,14,0,0,0,14
520,13,0,0,0,13
521,7,0,1,0,8
522,8,0,1,0,9
523,9,1,0,0,10
524,8,2,0,0,10
525,8,3,0,0,11
526,8,3,0,0,11
527,6,2,0,0,8
528,8,2,0,0,10
529,9,2,0,0,11
530,10,2,1,0,13
531,13,3,0,0,16
532,15,2,0,0,17
533,14,4,0,0,18
534,13,3,0,0,16
535,16,2,0,0,18
536,16,2,0,0,18
537,18,2,0,0,20
538,13,1,0,0,14
539,16,1,0,0,17
540,14,1,0,0,15
541,14,2,0,0,16
542,13,1,0,0,14
543,14,0,0,0,14
544,16,1,0,0,17
545,15,0,0,0,15
546,13,1,0,0,14
547,13,2,0,0,15
548,12,0,0,0,12
549,17,0,0,0,17
550,16,0,0,0,16
551,16,0,0,0,16
552,14,1,0,0,15
553,18,0,0,0,18
554,16,0,0,0,16
555,14,2,0,0,16
556,15,2,0,0,17
557,13,0,1,0,14
558,15,3,0,0,18
559,12,2,0,0,14
560,13,2,0,0,15
561,13,3,0,0,16
562,10,2,0,0,12
563,16,1,1,0,18
564,14,1,1,0,16
565,17,1,1,0,19
566,16,1,0,0,17
567,16,1,0,0,17
568,16,0,1,0,17
569,14,2,0,0,16
570,15,2,0,0,17
571,13,2,0,0,15
572,12,2,0,0,14
573,10,2,0,0,12
574,14,2,0,0,16
575,14,1,0,0,15
576,15,2,0,0,17
577,14,1,0,0,15
578,13,1,0,0,14
579,12,1,0,0,13
580,11,0,0,0,11
581,9,0,0,0,9
582,14,0,0,0,14
583,12,0,0,0,12
584,15,0,0,0,15
585,13,0,0,0,13
586,13,0,0,0,13
587,17,1,0,0,18
588,16,1,0,0,17
589,12,0,0,0,12
590,8,1,0,0,9
591,7,0,0,0,7
592,8,0,0,0,8
593,8,0,0,0,8
594,7,0,0,0,7
595,9,0,0,0,9
596,9,0,0,0,9
597,12,2,0,0,14
598,8,1,0,0,9
599,10,2,0,0,12
600,13,2,0,0,15
601,14,1,0,0,15
602,13,1,0,0,14
603,13,2,0,0,15
604,14,1,0,0,15
605,16,1,0,0,17
606,16,2,0,0,18
607,18,0,0,0,18
608,12,0,0,0,12
609,11,0,0,0,11
610,9,0,0,0,9
611,12,0,0,0,12
612,15,1,0,0,16
613,13,1,0,0,14
614,13,1,0,0,14
615,13,3,0,0,16
616,11,2,0,0,13
617,14,1,0,0,15
618,12,1,0,0,13
619,10,0,0,0,10
620,8,1,0,0,9
621,8,1,0,0,9
622,10,0,0,0,10
623,11,0,0,0,11
624,7,1,0,0,8
625,9,1,0,0,10
626,5,2,0,0,7
627,4,1,0,0,5
628,12,1,0,0,13
629,10,1,0,0,11
630,10,2,1,0,13
631,9,2,1,0,12
632,13,4,0,0,17
633,15,2,0,0,17
634,15,2,0,0,17
635,13,2,0,0,15
636,15,1,0,0,16
637,14,0,0,0,14
638,16,1,0,0,17
639,17,0,0,0,17
640,16,1,0,0,17
641,17,1,0,0,18
642,14,1,0,0,15
643,15,2,0,0,17
644,13,1,0,0,14
645,11,3,0,0,14
646,13,2,0,0,15
647,12,2,0,0,14
648,10,1,0,0,11
649,15,1,0,0,16
650,12,1,0,0,13
651,13,2,0,0,15
652,15,2,0,0,17
653,15,2,1,0,18
654,15,0,1,0,16
655,16,2,1,0,19
656,13,1,1,0,15
657,11,1,0,0,12
658,13,0,0,0,13
659,12,1,0,0,13
660,13,0,0,0,13
661,13,0,0,0,13
662,14,0,0,0,14
663,12,0,0,0,12
664,10,0,0,0,10
665,10,1,0,0,11
666,12,1,0,0,13
667,15,1,0,0,16
668,14,1,0,0,15
669,19,0,0,0,19
670,15,0,0,0,15
671,21,0,0,0,21
672,16,0,0,0,16
673,13,2,1,0,16
674,14,0,0,0,14
675,13,0,0,0,13
676,16,0,0,0,16
677,15,0,0,0,15
678,18,0,0,0,18
679,14,0,0,0,14
680,17,1,0,0,18
681,16,1,0,0,17
682,14,1,0,0,15
683,15,1,0,0,16
684,15,0,0,1,16
685,15,0,0,0,15
686,16,0,0,0,16
687,15,0,0,0,15
688,13,2,0,0,15
689,13,0,1,0,14
690,15,1,0,0,16
691,12,2,0,0,14
692,11,2,0,0,13
693,13,1,0,0,14
694,11,2,0,0,13
695,14,0,0,0,14
696,15,0,0,0,15
697,16,1,0,0,17
698,15,1,0,0,16
699,14,1,0,0,15
700,10,1,1,0,12
701,8,2,0,0,10
702,10,0,1,0,11
703,10,0,1,0,11
704,14,1,0,0,15
705,12,1,0,0,13
706,11,1,0,0,12
707,14,1,0,0,15
708,12,1,0,0,13
709,12,1,0,0,13
710,14,1,0,0,15
711,14,0,0,0,14
712,12,0,0,0,12
713,11,0,0,0,11
714,13,0,0,0,13
715,14,0,0,0,14
716,11,0,0,0,11
717,13,0,0,0,13
718,12,0,0,0,12
719,10,0,0,0,10
720,12,0,0,0,12
721,12,1,0,0,13
722,11,2,0,0,13
723,9,0,0,0,9
724,10,0,0,0,10
725,10,1,0,0,11
726,13,0,0,0,13
727,11,0,0,0,11
728,11,2,0,0,13
729,9,0,0,0,9
730,10,0,0,0,10
731,9,0,0,0,9
732,9,0,0,0,9
733,10,0,0,0,10
734,9,1,0,0,10
735,8,0,0,0,8
736,8,0,0,0,8
737,7,0,0,0,7
738,8,0,0,0,8
739,8,0,0,0,8
740,8,0,0,0,8
741,7,1,0,0,8
742,8,1,0,0,9
743,9,1,0,0,10
744,11,1,0,0,12
745,8,1,0,0,9
746,9,1,0,0,10
747,12,0,0,0,12
748,10,0,0,0,10
749,11,0,0,0,11
750,11,0,0,0,11
751,10,1,0,0,11
752,9,2,0,0,11
753,9,1,1,0,11
754,10,1,1,0,12
755,10,3,0,0,13
756,8,2,0,0,10
757,5,2,0,0,7
758,4,2,0,0,6
759,7,3,0,0,10
760,8,1,1,0,10
761,6,2,0,0,8
762,7,2,0,0,9
763,8,2,0,0,10
764,10,1,0,0,11
765,10,1,0,0,11
766,7,1,0,0,8
767,9,0,1,0,10
768,8,2,1,0,11
769,8,1,2,0,11
770,10,2,0,0,12
771,11,2,0,0,13
772,9,3,0,0,12
773,7,1,0,0,8
774,5,0,0,0,5
775,4,1,0,0,5
776,4,1,0,0,5
777,6,1,0,0,7
778,9,1,0,0,10
779,9,1,1,0,11
780,8,2,0,0,10
781,11,1,0,0,12
782,10,1,0,0,11
783,9,1,0,0,10
784,10,1,0,0,11
785,9,1,0,0,10
786,8,2,0,0,10
787,10,1,0,0,11
788,11,1,0,0,12
789,14,0,0,0,14
790,10,0,0,0,10
791,12,0,0,0,12
792,11,0,0,0,11
793,12,0,0,0,12
794,9,1,0,0,10
795,8,1,0,0,9
796,11,0,1,0,12
797,14,0,0,0,14
798,13,1,0,0,14
799,8,0,0,0,8
800,11,0,0,0,11
801,11,0,0,0,11
802,9,0,0,0,9
803,10,0,0,0,10
804,8,1,0,0,9
805,9,0,0,0,9
806,8,0,0,0,8
807,12,0,0,0,12
808,10,0,0,0,10
809,12,0,0,0,12
810,10,0,0,0,10
811,10,0,0,0,10
812,9,0,0,0,9
813,7,0,0,0,7
814,11,0,0,0,11
815,7,1,0,0,8
816,10,1,0,0,11
817,12,0,0,0,12
818,12,0,0,0,12
819,13,0,0,0,13
820,9,2,0,0,11
821,7,3,0,0,10
822,10,1,0,0,11
823,10,1,1,0,12
824,11,2,0,0,13
825,11,0,0,0,11
826,11,0,1,0,12
827,10,1,0,0,11
828,9,0,0,0,9
829,9,0,0,0,9
830,7,1,0,0,8
831,9,1,0,0,10
832,8,0,1,0,9
833,10,2,0,0,12
834,11,1,0,0,12
835,10,1,0,0,11
836,9,1,0,0,10
837,10,1,0,0,11
838,12,1,0,0,13
839,11,1,0,0,12
840,13,1,0,0,14
841,13,0,1,0,14
842,16,0,0,0,16
843,14,0,0,0,14
844,14,1,0,0,15
845,13,0,0,0,13
846,13,1,0,0,14
847,10,2,0,0,12
848,12,1,2,0,15
849,10,3,0,0,13
850,10,1,0,0,11
851,16,1,0,0,17
852,12,0,0,0,12
853,12,0,0,0,12
854,12,0,0,0,12
855,8,0,0,0,8
856,6,0,0,0,6
857,6,1,0,0,7
858,7,0,0,0,7
859,9,1,0,0,10
860,10,1,0,0,11
861,7,1,1,0,9
862,5,3,0,0,8
863,8,3,0,0,11
864,10,4,0,0,14
865,11,4,0,0,15
866,11,1,1,0,13
867,15,1,0,0,16
868,14,1,0,0,15
869,12,0,0,0,12
870,10,0,0,0,10
871,13,0,0,0,13
872,15,0,0,0,15
873,7,0,0,0,7
874,10,0,0,0,10
875,12,2,0,0,14
876,9,3,1,0,13
877,13,2,0,0,15
878,16,2,0,0,18
879,14,1,0,0,15
880,15,1,0,0,16
881,14,2,0,0,16
882,13,1,0,0,14
883,15,0,0,0,15
884,13,0,0,0,13
885,12,0,0,0,12
886,14,0,0,0,14
887,15,0,0,0,15
888,13,0,0,0,13
889,13,0,0,0,13
890,13,0,0,0,13
891,14,1,0,0,15
892,13,0,0,0,13
893,15,1,0,0,16
894,16,2,1,0,19
895,10,0,1,0,11
896,9,1,0,0,10
897,11,2,0,0,13
898,12,1,1,0,14
899,12,4,0,0,16
900,18,1,0,0,19
901,14,1,0,0,15
902,15,0,0,0,15
903,15,0,0,0,15
904,15,0,0,0,15
905,12,0,0,0,12
906,14,0,0,0,14
907,15,0,0,0,15
908,13,1,0,0,14
909,15,1,0,0,16
910,13,2,0,0,15
911,15,2,0,0,17
912,14,3,0,0,17
913,12,1,0,0,13
914,15,0,0,0,15
915,12,1,0,0,13
916,13,0,0,0,13
917,13,0,0,0,13
918,12,0,0,0,12
919,13,0,0,0,13
920,12,0,0,0,12
921,10,0,0,0,10
922,12,0,0,0,12
923,12,0,0,0,12
924,13,0,0,0,13
925,11,0,0,0,11
926,12,0,0,0,12
927,14,0,0,0,14
928,16,0,0,0,16
929,17,0,0,0,17
930,15,2,0,0,17
931,13,2,0,0,15
932,13,3,0,0,16
933,11,1,1,0,13
934,15,1,1,0,17
935,14,1,0,0,15
936,18,1,0,0,19
937,17,1,0,0,18
938,17,0,0,0,17
939,14,0,0,0,14
940,12,0,0,0,12
941,14,0,0,0,14
942,14,0,0,0,14
943,17,0,0,0,17
944,14,2,0,0,16
945,11,2,0,0,13
946,13,1,0,0,14
947,11,2,1,0,14
948,9,1,0,0,10
949,11,0,0,0,11
950,11,1,0,0,12
951,9,0,0,0,9
952,10,0,0,0,10
953,12,0,0,0,12
954,13,0,0,0,13
955,12,1,0,0,13
956,14,0,0,0,14
957,17,1,0,0,18
958,17,0,0,0,17
959,8,1,0,0,9
960,11,2,1,0,14
961,10,1,1,0,12
962,13,2,0,0,15
963,13,2,0,0,15
964,10,2,0,0,12
965,11,1,0,0,12
966,17,1,0,0,18
967,17,0,0,0,17
968,17,0,0,0,17
969,18,0,1,0,19
970,16,1,1,0,18
971,14,0,0,0,14
972,11,2,0,0,13
973,14,1,0,0,15
974,15,1,0,0,16
975,13,1,0,0,14
976,14,0,0,0,14
977,15,0,0,0,15
978,16,0,0,0,16
979,10,0,0,0,10
980,11,0,0,0,11
981,12,0,0,0,12
982,14,0,0,0,14
983,13,0,0,0,13
984,14,1,0,0,15
985,15,0,0,0,15
986,12,1,0,0,13
987,13,0,0,0,13
988,13,0,0,0,13
989,11,0,0,0,11
990,10,1,0,0,11
991,14,0,0,0,14
992,13,0,0,0,13
993,13,0,0,0,13
994,13,0,0,0,13
995,11,0,0,0,11
996,11,0,0,0,11
997,12,0,0,0,12
998,14,1,0,0,15
999,9,2,0,0,11
1000,13,1,0,0,14
1001,8,2,0,1,11
1002,9,1,0,0,10
1003,8,1,0,0,9
1004,9,1,0,0,10
1005,9,1,0,0,10
1006,8,1,0,0,9
1007,10,2,0,0,12
1008,11,1,0,0,12
1009,13,0,0,0,13
1010,13,0,0,0,13
1011,11,1,0,0,12
1012,15,0,0,0,15
1013,15,1,0,0,16
1014,13,1,0,0,14
1015,9,1,0,0,10
1016,11,2,0,0,13
1017,10,0,0,0,10
1018,11,1,0,0,12
1019,13,1,1,0,15
1020,13,0,1,0,14
1021,12,0,0,0,12
1022,16,0,0,0,16
1023,14,0,0,0,14
1024,17,0,0,0,17
1025,18,0,0,0,18
1026,13,1,0,0,14
1027,13,1,0,0,14
1028,14,1,0,0,15
1029,16,1,0,0,17
1030,13,0,0,0,13
1031,15,0,1,0,16
1032,11,0,0,0,11
1033,16,0,0,0,16
1034,16,0,0,0,16
1035,14,0,0,0,14
1036,14,0,0,0,14
1037,13,0,0,0,13
1038,13,1,0,0,14
1039,8,1,0,0,9
1040,10,2,0,0,12
1041,7,1,0,0,8
1042,15,2,0,0,17
1043,12,1,0,0,13
1044,13,1,0,0,14
1045,10,2,0,0,12
1046,9,3,1,0,13
1047,7,4,0,0,11
1048,7,3,0,0,10
1049,10,1,0,0,11
1050,10,0,0,0,10
1051,12,1,0,0,13
1052,12,0,1,0,13
1053,12,2,0,0,14
1054,13,1,0,0,14
1055,14,3,0,0,17
1056,14,1,0,0,15
1057,16,1,0,0,17
1058,15,0,0,0,15
1059,15,1,0,0,16
1060,15,2,0,0,17
1061,14,1,0,0,15
1062,14,0,0,0,14
1063,14,0,0,0,14
1064,17,1,0,0,18
1065,14,1,0,0,15
1066,16,1,0,0,17
1067,17,0,0,0,17
1068,14,0,0,0,14
1069,18,0,0,0,18
1070,20,1,0,0,21
1071,21,0,0,0,21
1072,20,0,0,0,20
1073,15,0,0,0,15
1074,19,0,0,0,19
1075,14,1,1,0,16
1076,14,1,0,0,15
1077,14,1,0,0,15
1078,15,1,0,0,16
1079,14,2,0,0,16
1080,14,2,0,0,16
1081,16,2,0,0,18
1082,14,1,0,0,15
1083,13,1,0,0,14
1084,13,0,0,0,13
1085,14,0,0,0,14
1086,16,0,0,0,16
1087,15,0,0,0,15
1088,15,0,0,0,15
1089,15,0,0,0,15
1090,15,0,0,0,15
1091,12,0,0,0,12
1092,18,0,0,0,18
1093,16,1,0,0,17
1094,14,1,0,0,15
1095,18,1,0,0,19
1096,14,2,0,0,16
1097,13,0,0,0,13
1098,14,0,1,0,15
1099,14,2,1,0,17
1100,15,0,1,0,16
1101,12,1,0,0,13
1102,13,1,0,0,14
1103,13,1,0,0,14
1104,12,1,0,0,13
1105,17,1,0,0,18
1106,14,0,0,0,14
1107,14,0,0,0,14
1108,13,1,0,0,14
1109,16,0,0,0,16
1110,16,1,0,0,17
1111,17,1,0,0,18
1112,18,1,0,0,19
1113,15,1,1,0,17
1114,19,2,0,0,21
1115,16,2,0,0,18
1116,15,0,0,0,15
1117,17,0,0,0,17
1118,16,1,0,0,17
1119,14,0,1,0,15
1120,14,1,0,0,15
1121,15,0,0,0,15
1122,12,0,0,0,12
1123,11,0,0,0,11
1124,9,0,0,0,9
1125,11,0,0,0,11
1126,13,0,0,0,13
1127,13,1,0,0,14
1128,12,0,0,0,12
1129,14,1,0,0,15
1130,15,1,0,0,16
1131,13,1,0,0,14
1132,12,1,0,0,13
1133,13,1,0,0,14
1134,16,1,0,0,17
1135,14,2,0,0,16
1136,14,1,0,0,15
1137,13,2,0,0,15
1138,14,1,0,0,15
1139,12,1,0,0,13
1140,14,1,0,0,15
1141,15,1,0,0,16
1142,14,1,0,0,15
1143,12,0,0,0,12
1144,11,2,0,0,13
1145,9,1,0,0,10
1146,8,2,0,0,10
1147,10,1,1,0,12
1148,7,1,1,0,9
1149,9,1,0,0,10
1150,6,0,0,0,6
1151,7,0,0,0,7
1152,7,0,0,0,7
1153,9,0,0,0,9
1154,8,1,0,0,9
1155,9,0,0,0,9
1156,7,0,0,0,7
1157,9,0,0,0,9
1158,12,0,0,0,12
1159,14,0,0,0,14
1160,13,1,0,0,14
1161,13,0,1,0,14
1162,14,2,1,0,17
1163,17,1,0,0,18
1164,16,1,0,0,17
1165,15,1,0,0,16
1166,17,1,0,0,18
1167,15,0,0,0,15
1168,16,0,0,0,16
1169,18,0,0,0,18
1170,16,1,0,0,17
1171,15,0,0,0,15
1172,18,0,0,0,18
1173,18,0,0,0,18
1174,17,0,0,0,17
1175,16,0,0,0,16
1176,18,0,0,0,18
1177,18,0,0,0,18
1178,18,1,0,0,19
1179,17,0,0,0,17
1180,14,1,0,0,15
1181,14,1,0,0,15
1182,15,0,0,0,15
1183,14,1,0,0,15
1184,13,2,0,0,15
1185,13,2,0,0,15
1186,16,1,0,0,17
1187,19,0,0,0,19
1188,16,0,0,0,16
1189,17,0,0,0,17
1190,18,0,0,0,18
1191,15,1,0,0,16
1192,15,0,0,0,15
1193,20,2,0,0,22
1194,15,2,0,0,17
1195,13,3,0,0,16
1196,14,2,0,0,16
1197,15,1,0,0,16
1198,18,0,1,0,19
1199,15,1,0,0,16
1200,10,1,0,0,11
1201,15,1,0,0,16
1202,13,1,0,0,14
1203,15,0,0,0,15
1204,13,1,0,0,14
1205,12,2,0,0,14
1206,17,2,0,0,19
1207,15,0,0,0,15
1208,18,0,0,0,18
1209,13,2,0,0,15
1210,13,0,0,0,13
1211,14,0,0,0,14
1212,9,1,0,0,10
1213,13,1,0,0,14
1214,14,0,0,0,14
1215,9,1,0,0,10
1216,11,0,0,0,11
1217,10,1,0,0,11
1218,11,0,0,0,11
1219,10,0,0,0,10
1220,12,0,0,0,12
1221,10,1,0,0,11
1222,9,1,0,0,10
1223,11,1,0,0,12
1224,9,1,0,0,10
1225,12,1,0,0,13
1226,14,1,0,0,15
1227,15,1,0,0,16
1228,12,1,0,0,13
1229,8,1,0,0,9
1230,9,0,1,0,10
1231,10,1,0,0,11
1232,10,1,0,0,11
1233,9,1,0,0,10
1234,6,1,0,0,7
1235,7,1,0,0,8
1236,11,1,0,0,12
1237,12,1,0,0,13
1238,12,0,0,0,12
1239,9,0,0,0,9
1240,8,0,0,0,8
1241,10,0,1,0,11
1242,10,0,1,0,11
1243,11,0,0,0,11
1244,11,0,0,0,11
1245,11,0,0,0,11
1246,14,0,0,0,14
1247,12,1,0,0,13
1248,10,1,0,0,11
1249,11,1,0,0,12
1250,13,0,1,0,14
1251,17,0,0,0,17
1252,13,0,0,0,13
1253,15,0,0,0,15
1254,16,1,0,0,17
1255,17,1,0,0,18
1256,14,2,0,0,16
1257,16,0,0,0,16
1258,8,0,1,0,9
1259,8,0,0,0,8
1260,11,0,0,0,11
1261,13,0,0,0,13
1262,12,1,0,0,13
1263,12,1,0,0,13
1264,13,3,0,0,16
1265,11,2,0,0,13
1266,11,1,0,0,12
1267,12,2,0,0,14
1268,10,1,0,0,11
1269,9,2,0,0,11
1270,6,0,0,0,6
1271,7,0,0,0,7
1272,8,0,0,0,8
1273,9,0,0,0,9
1274,11,0,0,0,11
1275,12,0,0,0,12
1276,12,0,0,0,12
1277,9,1,0,0,10
1278,9,1,0,0,10
1279,9,1,0,0,10
1280,10,1,0,0,11
1281,9,1,0,0,10
1282,8,1,0,0,9
1283,13,2,0,0,15
1284,10,2,0,0,12
1285,12,2,0,0,14
1286,12,2,0,0,14
1287,10,1,0,0,11
1288,11,1,0,0,12
1289,13,0,0,0,13
1290,13,0,0,0,13
1291,15,0,0,0,15
1292,12,0,0,0,12
1293,16,0,0,0,16
1294,15,1,0,0,16
1295,15,0,0,0,15
1296,14,0,0,0,14
1297,14,0,0,0,14
1298,13,1,0,0,14
1299,12,0,0,0,12
1300,9,1,1,0,11
1301,12,1,0,0,13
1302,10,1,0,0,11
1303,11,1,0,0,12
1304,9,3,0,0,12
1305,14,0,1,0,15
1306,13,1,0,0,14
1307,11,2,0,0,13
1308,11,2,0,0,13
1309,11,4,0,0,15
1310,12,1,1,0,14
1311,12,1,1,0,14
1312,9,0,0,0,9
1313,9,0,0,0,9
1314,11,0,0,0,11
1315,8,2,0,0,10
1316,9,0,0,0,9
1317,6,0,1,0,7
1318,8,0,0,0,8
1319,12,0,0,0,12
1320,10,0,0,0,10
1321,8,0,0,0,8
1322,9,0,0,0,9
1323,10,0,0,0,10
1324,9,0,0,0,9
1325,10,0,0,0,10
1326,12,1,0,0,13
1327,13,0,0,0,13
1328,15,0,0,0,15
1329,11,1,0,0,12
1330,10,0,0,0,10
1331,11,0,1,0,12
1332,11,0,1,0,12
1333,12,1,0,0,13
1334,10,0,0,0,10
1335,9,0,0,0,9
1336,13,0,0,0,13
1337,12,2,0,0,14
1338,12,3,0,0,15
1339,12,1,0,0,13
1340,10,1,0,0,11
1341,8,1,0,0,9
1342,7,2,0,0,9
1343,9,1,0,0,10
1344,7,0,0,0,7
1345,8,1,1,0,10
1346,11,2,0,0,13
1347,12,1,0,0,13
1348,15,2,0,0,17
1349,16,0,1,0,17
1350,12,1,0,0,13
1351,14,1,0,0,15
1352,14,0,0,0,14
1353,12,0,0,0,12
1354,12,0,0,0,12
1355,14,1,0,0,15
1356,11,1,0,0,12
1357,8,1,0,0,9
1358,10,1,0,0,11
1359,10,2,0,0,12
1360,13,1,0,0,14
1361,11,1,0,0,12
1362,15,0,0,0,15
1363,12,1,0,0,13
1364,13,1,0,0,14
1365,16,0,0,0,16
1366,15,1,0,0,16
1367,14,0,0,0,14
1368,18,0,0,0,18
1369,15,0,0,0,15
1370,15,2,0,0,17
1371,14,1,1,0,16
1372,12,0,1,0,13
1373,15,0,0,0,15
1374,15,0,0,0,15
1375,15,0,0,0,15
1376,16,0,0,0,16
1377,12,0,0,0,12
1378,12,0,0,0,12
1379,11,0,0,0,11
1380,14,2,0,0,16
1381,13,2,1,0,16
1382,10,3,0,0,13
1383,14,2,0,0,16
1384,13,1,0,0,14
1385,16,1,0,0,17
1386,16,1,0,0,17
1387,16,2,0,0,18
1388,17,1,0,0,18
1389,17,0,0,0,17
1390,15,0,0,0,15
1391,13,1,0,0,14
1392,12,0,0,0,12
1393,14,0,0,0,14
1394,14,1,0,0,15
1395,12,0,0,0,12
1396,14,1,0,0,15
1397,17,1,0,0,18
1398,11,3,0,0,14
1399,11,2,1,0,14
1400,14,1,1,0,16
1401,14,1,0,0,15
1402,10,1,0,0,11
1403,10,0,0,0,10
1404,11,0,0,0,11
1405,12,0,0,0,12
1406,12,0,0,0,12
1407,12,0,0,0,12
1408,11,2,0,0,13
1409,5,1,0,0,6
1410,9,0,0,0,9
1411,11,2,0,0,13
1412,12,1,0,0,13
1413,11,3,0,0,14
1414,10,5,0,0,15
1415,12,2,0,0,14
1416,11,1,0,0,12
1417,11,2,0,0,13
1418,11,2,0,0,13
1419,9,2,0,0,11
1420,8,0,0,0,8
1421,9,1,0,0,10
1422,11,0,1,0,12
1423,9,1,0,0,10
1424,13,1,0,0,14
1425,10,3,0,0,13
1426,10,2,0,0,12
1427,13,4,0,0,17
1428,12,4,0,0,16
1429,9,2,0,0,11
1430,13,3,0,0,16
1431,13,2,0,0,15
1432,13,1,0,0,14
1433,15,1,0,0,16
1434,10,3,0,0,13
1435,11,2,0,0,13
1436,12,2,0,0,14
1437,11,3,0,0,14
1438,9,1,0,0,10
1439,14,0,0,0,14
1440,10,1,0,0,11
1441,10,1,0,0,11
1442,13,2,0,0,15
1443,12,2,0,0,14
1444,16,2,0,0,18
1445,15,3,1,0,19
1446,14,2,0,0,16
1447,14,3,0,0,17
1448,12,3,0,0,15
1449,8,3,0,0,11
1450,9,3,0,0,12
1451,10,3,0,0,13
1452,11,2,0,0,13
1453,13,1,0,0,14
1454,10,1,0,0,11
1455,8,2,0,0,10
1456,10,1,0,0,11
1457,9,2,0,0,11
1458,8,3,0,0,11
1459,7,2,1,0,10
1460,6,0,1,0,7
1461,10,0,1,0,11
1462,11,2,1,0,14
1463,10,2,0,0,12
1464,9,3,1,0,13
1465,11,3,0,0,14
1466,11,1,1,0,13
1467,12,1,1,0,14
1468,16,2,0,0,18
1469,14,1,0,0,15
1470,11,1,0,0,12
1471,12,1,0,0,13
1472,7,2,0,0,9
1473,9,1,0,0,10
1474,8,1,0,0,9
1475,12,1,0,0,13
1476,12,1,0,0,13
1477,14,2,0,0,16
1478,8,1,0,0,9
1479,9,3,0,0,12
1480,10,2,0,0,12
1481,11,2,0,0,13
1482,10,1,0,0,11
1483,14,2,0,0,16
1484,13,1,0,0,14
1485,13,1,0,0,14
1486,15,1,0,0,16
1487,12,0,0,0,12
1488,12,1,0,0,13
1489,13,1,0,0,14
1490,14,1,0,0,15
1491,16,2,0,0,18
1492,14,2,1,0,17
1493,12,1,0,0,13
1494,9,3,0,0,12
1495,11,2,0,0,13
1496,10,4,0,0,14
1497,14,2,0,0,16
1498,13,1,0,0,14
1499,15,1,0,0,16
1500,12,1,0,0,13
1501,15,0,0,0,15
1502,14,0,0,0,14
1503,16,0,0,0,16
1504,15,1,0,0,16
1505,15,2,1,0,18
1506,15,1,0,0,16
1507,18,1,0,0,19
1508,14,1,0,0,15
1509,16,0,0,0,16
1510,16,0,0,0,16
1511,14,1,0,0,15
1512,15,1,0,0,16
1513,10,1,0,0,11
1514,11,0,1,0,12
1515,15,1,0,0,16
1516,14,0,0,0,14
1517,13,0,0,0,13
1518,11,0,0,0,11
1519,10,1,1,0,12
1520,11,0,0,0,11
1521,13,0,0,0,13
1522,13,0,0,0,13
1523,12,0,0,0,12
1524,9,0,0,0,9
1525,14,0,0,0,14
1526,9,2,0,0,11
1527,10,0,1,0,11
1528,11,1,0,0,12
1529,12,0,0,0,12
1530,10,1,0,0,11
1531,11,0,0,0,11
1532,13,0,0,0,13
1533,11,0,0,0,11
1534,15,0,0,0,15
1535,18,1,0,0,19
1536,16,1,0,0,17
1537,13,2,0,0,15
1538,12,1,0,0,13
1539,11,2,0,0,13
1540,11,2,0,0,13
1541,12,2,0,0,14
1542,10,0,0,0,10
1543,6,2,0,0,8
1544,11,0,0,0,11
1545,11,0,0,0,11
1546,11,0,0,0,11
1547,13,0,0,0,13
1548,16,1,0,0,17
1549,14,1,0,0,15
1550,15,0,0,0,15
1551,15,0,0,0,15
1552,13,0,0,0,13
1553,12,0,0,0,12
1554,13,1,1,0,15
1555,12,1,1,0,14
1556,13,2,0,0,15
1557,16,1,0,0,17
1558,17,2,0,0,19
1559,16,2,0,0,18
1560,11,2,1,0,14
1561,13,0,0,0,13
1562,17,1,0,0,18
1563,13,2,0,0,15
1564,13,2,1,0,16
1565,15,2,0,0,17
1566,18,2,0,0,20
1567,17,1,0,0,18
1568,19,0,0,0,19
1569,18,1,0,0,19
1570,20,1,0,0,21
1571,18,0,0,0,18
1572,15,1,0,0,16
1573,14,0,0,0,14
1574,13,0,0,0,13
1575,15,0,0,0,15
1576,15,0,0,0,15
1577,15,1,0,0,16
1578,16,0,0,0,16
1579,16,0,0,0,16
1580,12,0,0,0,12
1581,16,1,0,0,17
1582,14,1,0,0,15
1583,15,1,0,0,16
1584,15,2,0,0,17
1585,12,0,0,0,12
1586,12,1,0,0,13
1587,12,0,0,0,12
1588,12,1,0,0,13
1589,11,0,0,0,11
1590,9,0,1,0,10
1591,9,1,0,0,10
1592,12,1,0,0,13
1593,14,1,0,0,15
1594,10,1,0,0,11
1595,11,1,0,0,12
1596,11,2,0,0,13
1597,15,0,0,0,15
1598,12,0,0,0,12
1599,11,0,0,0,11
1600,11,0,1,0,12
1601,9,1,0,0,10
1602,10,2,0,0,12
1603,12,1,0,0,13
1604,12,1,0,0,13
1605,12,1,0,0,13
1606,14,1,0,0,15
1607,12,1,0,0,13
1608,13,1,0,0,14
1609,13,0,0,0,13
1610,14,0,0,0,14
1611,15,0,0,0,15
1612,12,1,0,0,13
1613,13,1,1,0,15
1614,14,1,0,0,15
1615,11,1,0,0,12
1616,13,2,0,0,15
1617,14,1,0,0,15
1618,11,1,0,0,12
1619,13,2,0,0,15
1620,16,3,0,0,19
1621,13,1,1,0,15
1622,14,2,0,0,16
1623,14,1,0,0,15
1624,16,1,0,0,17
1625,14,2,0,0,16
1626,15,0,0,0,15
1627,11,1,0,0,12
1628,9,3,0,0,12
1629,10,1,0,0,11
1630,11,2,0,0,13
1631,12,1,1,0,14
1632,12,2,1,0,15
1633,13,0,0,0,13
1634,14,1,0,0,15
1635,14,0,0,0,14
1636,16,0,0,0,16
1637,15,2,0,0,17
1638,14,4,0,0,18
1639,13,2,1,0,16
1640,17,2,1,0,20
1641,14,1,1,0,16
1642,15,0,1,0,16
1643,15,0,0,0,15
1644,12,0,0,0,12
1645,14,0,0,0,14
1646,13,1,0,0,14
1647,14,1,0,0,15
1648,17,0,0,0,17
1649,17,0,0,0,17
1650,16,1,1,0,18
1651,13,0,1,0,14
1652,15,0,1,0,16
1653,15,3,0,0,18
1654,13,0,2,0,15
1655,14,2,0,0,16
1656,16,2,0,0,18
1657,15,2,0,0,17
1658,14,2,0,0,16
1659,16,2,0,0,18
1660,14,3,0,0,17
1661,14,1,0,0,15
1662,13,1,0,0,14
1663,13,0,0,0,13
1664,12,2,0,0,14
1665,13,1,0,0,14
1666,13,1,0,0,14
1667,11,1,0,0,12
1668,12,1,0,0,13
1669,14,1,0,0,15
1670,15,1,0,0,16
1671,15,2,0,0,17
1672,17,0,0,0,17
1673,16,2,0,0,18
1674,16,1,0,0,17
1675,14,1,0,0,15
1676,13,1,0,0,14
1677,10,0,0,0,10
1678,9,0,0,0,9
1679,8,1,0,0,9
1680,8,0,0,0,8
1681,8,0,0,0,8
1682,11,0,0,0,11
1683,11,0,0,0,11
1684,14,1,0,0,15
1685,14,2,0,0,16
1686,14,2,0,0,16
1687,17,2,0,0,19
1688,14,1,0,0,15
1689,17,1,0,0,18
1690,17,0,0,0,17
1691,15,0,0,0,15
1692,18,0,0,0,18
1693,16,1,0,0,17
1694,14,0,1,0,15
1695,16,2,0,0,18
1696,10,3,0,0,13
1697,12,2,0,0,14
1698,7,1,1,0,9
1699,9,1,1,0,11
1700,11,2,2,0,15
1701,13,2,2,0,17
1702,12,2,0,0,14
1703,10,3,1,0,14
1704,14,2,0,0,16
1705,14,3,0,0,17
1706,13,3,0,0,16
1707,14,1,0,0,15
1708,14,1,0,0,15
1709,13,1,0,0,14
1710,13,1,0,0,14
1711,11,0,0,0,11
1712,11,1,0,0,12
1713,16,0,0,0,16
1714,17,0,0,0,17
1715,14,0,0,0,14
1716,17,0,0,0,17
1717,17,1,0,0,18
1718,15,0,0,0,15
1719,16,0,0,0,16
1720,13,2,0,0,15
1721,14,0,0,0,14
1722,18,1,0,0,19
1723,15,1,0,0,16
1724,11,3,0,0,14
1725,17,0,0,0,17
1726,14,1,0,0,15
1727,13,3,0,0,16
1728,8,2,0,0,10
1729,10,2,0,0,12
1730,12,2,0,0,14
1731,13,3,0,0,16
1732,12,1,0,0,13
1733,12,2,0,0,14
1734,15,1,0,0,16
1735,14,0,0,0,14
1736,12,2,0,0,14
1737,13,3,0,0,16
1738,13,3,1,0,17
1739,12,2,2,0,16
1740,16,2,2,0,20
1741,16,2,1,0,19
1742,16,2,0,0,18
1743,15,2,1,0,18
1744,15,2,0,0,17
1745,16,0,0,0,16
1746,16,3,0,0,19
1747,16,1,0,0,17
1748,12,2,0,0,14
1749,13,1,0,0,14
1750,12,2,0,0,14
1751,12,2,0,0,14
1752,11,2,0,0,13
1753,16,2,0,0,18
1754,13,3,0,0,16
1755,12,3,0,0,15
1756,14,3,0,0,17
1757,12,3,0,0,15
1758,12,1,0,0,13
1759,12,2,0,0,14
1760,13,1,0,0,14
1761,12,0,0,0,12
1762,11,2,0,0,13
1763,11,1,0,0,12
1764,11,1,0,0,12
1765,12,2,0,0,14
1766,13,1,0,0,14
1767,12,1,0,0,13
1768,13,1,0,0,14
1769,15,2,0,0,17
1770,14,2,0,0,16
1771,15,1,0,0,16
1772,21,0,0,0,21
1773,14,0,0,0,14
1774,17,0,0,0,17
1775,16,0,0,0,16
1776,17,0,0,0,17
1777,17,1,0,0,18
1778,18,1,0,0,19
1779,17,1,0,0,18
1780,20,1,0,0,21
1781,21,1,0,0,22
1782,18,0,1,0,19
1783,19,0,1,0,20
1784,15,1,1,0,17
1785,16,0,1,0,17
1786,16,2,0,0,18
1787,16,2,0,0,18
1788,15,3,0,0,18
1789,14,1,0,0,15
1790,17,0,0,0,17
1791,17,0,0,0,17
1792,17,0,0,0,17
1793,19,2,0,0,21
1794,19,0,0,0,19
1795,21,1,0,0,22
1796,19,1,1,0,21
1797,20,2,0,0,22
1798,18,1,0,0,19
1799,15,2,0,0,17
1800,17,0,0,0,17
1801,16,0,0,0,16
1802,17,0,0,0,17
1803,16,0,0,0,16
1804,15,0,0,0,15
1805,14,1,0,0,15
1806,14,1,0,0,15
1807,15,2,1,0,18
1808,18,2,0,0,20
1809,14,1,0,0,15
1810,15,1,0,0,16
1811,17,0,0,0,17
1812,16,1,0,0,17
1813,14,0,0,0,14
1814,9,0,0,0,9
1815,13,0,0,0,13
1816,13,0,0,0,13
1817,12,0,0,0,12
1818,15,0,0,0,15
1819,10,1,0,0,11
1820,15,1,0,0,16
1821,13,1,0,0,14
1822,14,1,1,0,16
1823,12,2,0,0,14
1824,14,1,0,0,15
1825,14,1,0,0,15
1826,12,2,1,0,15
1827,13,0,1,0,14
1828,17,0,1,0,18
1829,15,1,0,0,16
1830,14,0,0,0,14
1831,15,1,0,0,16
1832,12,3,1,0,16
1833,13,2,0,0,15
1834,13,1,0,0,14
1835,17,1,0,0,18
1836,19,1,0,0,20
1837,14,1,0,0,15
1838,16,1,0,0,17
1839,13,1,0,0,14
1840,11,0,0,0,11
1841,12,0,0,0,12
1842,13,1,0,0,14
1843,11,1,0,0,12
1844,11,1,0,0,12
1845,12,1,0,0,13
1846,12,2,0,0,14
1847,11,2,0,0,13
1848,10,1,1,0,12
1849,9,3,0,0,12
1850,10,1,0,0,11
1851,12,1,0,0,13
1852,10,1,0,0,11
1853,11,0,0,0,11
1854,12,0,0,0,12
1855,9,0,0,0,9
1856,9,0,0,0,9
1857,11,0,0,0,11
1858,11,0,0,0,11
1859,12,0,0,0,12
1860,15,0,0,0,15
1861,13,2,0,0,15
1862,16,0,0,0,16
1863,14,0,0,0,14
1864,14,0,0,0,14
1865,16,0,0,0,16
1866,14,0,0,0,14
1867,16,0,0,0,16
1868,17,0,0,0,17
1869,18,0,0,0,18
1870,15,1,0,0,16
1871,14,0,0,0,14
1872,16,0,0,0,16
1873,17,1,0,0,18
1874,17,0,0,0,17
1875,14,1,0,0,15
1876,14,2,0,0,16
1877,15,2,0,0,17
1878,12,2,0,0,14
1879,16,2,0,0,18
1880,12,2,0,0,14
1881,14,2,0,0,16
1882,13,3,0,0,16
1883,14,1,0,0,15
1884,12,2,0,0,14
1885,15,1,0,0,16
1886,12,1,0,0,13
1887,15,0,0,0,15
1888,15,0,0,0,15
1889,16,0,0,0,16
1890,14,0,0,0,14
1891,15,2,0,0,17
1892,18,2,0,0,20
1893,15,2,0,0,17
1894,13,2,0,0,15
1895,9,1,1,0,11
1896,10,2,0,0,12
1897,14,2,0,0,16
1898,16,1,0,0,17
1899,17,2,0,0,19
1900,16,2,0,0,18
1901,15,1,0,0,16
1902,14,0,0,0,14
1903,15,1,0,0,16
1904,16,1,0,0,17
1905,18,1,0,0,19
1906,15,1,0,0,16
1907,10,1,0,0,11
1908,11,1,0,0,12
1909,10,1,0,0,11
1910,14,1,0,0,15
1911,13,2,0,0,15
1912,13,0,0,0,13
1913,13,1,0,0,14
1914,10,1,0,0,11
1915,11,0,0,0,11
1916,12,1,0,0,13
1917,15,1,0,0,16
1918,17,1,0,0,18
1919,16,0,0,0,16
1920,16,0,0,0,16
1921,12,1,0,0,13
1922,12,0,1,0,13
1923,14,0,1,0,15
1924,13,0,1,0,14
1925,15,0,1,0,16
1926,13,1,0,0,14
1927,12,1,0,0,13
1928,13,1,0,0,14
1929,15,1,0,0,16
1930,15,2,0,0,17
1931,18,0,0,0,18
1932,16,1,0,0,17
1933,14,0,0,0,14
1934,15,0,0,0,15
1935,14,0,0,0,14
1936,15,0,0,0,15
1937,15,0,0,0,15
1938,16,0,0,0,16
1939,13,0,0,0,13
1940,17,0,0,0,17
1941,14,1,0,0,15
1942,8,0,1,0,9
1943,16,0,0,0,16
1944,13,0,0,0,13
1945,12,0,0,0,12
1946,14,1,0,0,15
1947,12,0,0,0,12
1948,15,0,0,0,15
1949,11,0,0,0,11
1950,14,0,0,0,14
1951,11,0,0,0,11
1952,8,0,0,0,8
1953,8,0,2,0,10
1954,5,0,1,0,6
1955,5,2,1,0,8
1956,8,2,0,0,10
1957,6,2,1,0,9
1958,12,1,1,0,14
1959,9,4,0,0,13
1960,11,2,0,0,13
1961,11,2,0,0,13
1962,12,2,0,0,14
1963,8,1,0,0,9
1964,11,1,0,0,12
1965,13,0,0,0,13
1966,14,0,0,0,14
1967,14,1,0,0,15
1968,17,0,0,0,17
1969,18,0,0,0,18
1970,15,1,0,0,16
1971,14,0,0,0,14
1972,13,0,0,0,13
1973,18,1,0,0,19
1974,16,1,0,0,17
1975,19,0,2,0,21
1976,16,2,0,0,18
1977,16,1,2,0,19
1978,13,2,0,0,15
1979,17,2,0,0,19
1980,16,1,1,0,18
1981,17,2,1,0,20
1982,16,1,0,0,17
1983,16,2,0,0,18
1984,14,2,0,0,16
1985,13,1,1,0,15
1986,11,2,0,0,13
1987,12,3,0,0,15
1988,13,2,1,0,16
1989,13,2,0,0,15
1990,14,2,0,0,16
1991,13,2,0,0,15
1992,12,3,0,0,15
1993,16,2,0,0,18
1994,14,2,0,0,16
1995,14,3,0,0,17
1996,17,2,0,0,19
1997,19,0,0,0,19
1998,19,0,0,0,19
1999,20,0,0,0,20
2000,20,0,0,0,20
2001,21,0,0,0,21
2002,20,0,0,0,20
2003,15,1,0,0,16
2004,20,1,0,0,21
2005,19,0,0,0,19
2006,18,0,0,0,18
2007,18,0,0,0,18
2008,17,0,0,0,17
2009,18,0,0,0,18
2010,19,2,1,0,22
2011,17,0,0,0,17
2012,17,0,0,0,17
2013,17,0,0,0,17
2014,15,0,0,0,15
2015,18,0,0,0,18
2016,19,1,0,0,20
2017,19,1,0,0,20
2018,18,1,0,0,19
2019,17,1,0,0,18
2020,17,0,0,0,17
2021,13,1,0,0,14
2022,16,1,0,0,17
2023,18,1,2,0,21
2024,20,0,2,0,22
2025,18,3,1,0,22
2026,20,4,0,0,24
2027,14,3,0,0,17
2028,13,4,0,0,17
2029,15,3,0,0,18
2030,14,2,0,0,16
2031,17,2,0,0,19
2032,13,2,0,0,15
2033,17,2,0,0,19
2034,17,0,0,0,17
2035,18,0,0,0,18
2036,21,0,0,0,21
2037,22,0,0,0,22
2038,21,2,0,0,23
2039,17,2,0,0,19
2040,16,1,0,0,17
2041,21,0,1,0,22
2042,18,0,0,0,18
2043,0,0,0,0,0
2044,0,0,0,0,0
2045,0,0,0,0,0
2046,0,0,0,0,0
2047,0,0,0,0,0
2048,0,0,0,0,0
2049,0,0,0,0,0
2050,0,0,0,0,0
